VVVVVVVVVVVHVVVVVHVVVVVVVVVVVVVVVVVVVVVVVVVVVV
VVVVVVVVVVVHVVVVVHVVVVVVVVVVVVVVVVVVVVVVVVVVVV
VVVVVVVVVVVHVVVVVHVVVVVVVVVVVVVVVVVVVVVVVVVVVV
VVVVVVVVVVVHVVVVVHVVVVVVVVVVVVVVVVVVVVVVVVVVVV
PPPPPPPPPPPPPPPPPPPPPPPPPPPPPPPPPPPPPPPPPPPPPP
VVVVVVVVVVVHVVVVVVVVVVVVVVVVVVVVVVHVVVVVVVVVVV
VVVVVVVVVVVHVVVVVVVVVVVVVVVVVVVVVVHVVVVVVVVVVV
VVVVVVVVVVVHVVVVVVVVVVVVVVVVVVVVVVHVVVVVVVVVVV
VVVVVVVVVVVHVVVVVVVVVVVVVVVVVVVVVVHVVVVVVVVVVV
VVVVVVVVVVVHVVVVVVVVVVVVVVVVVVVVVVHVVVVVVVVVVV
VVVVVPPPPPPPPPPPPPPPVVVVVVVVVVVVVVVVVVVVVVVVVV
VVVVVVVVVVVHVVVVVVVVVVVVVVVVVVVVVVVVVVVVVVVVVV
VVVVVVVVVVVHVVVVVVVVVVVVVVVVVVVVVVVVVVVVVVVVVV
VVVVVVVVVVVHVVVVVVVVVVVVVVVVVVVVVVVVVVVVVVVVVV
VVVVVVVVVVVHVVVVVVVVVVVVVVVVVVVVVVVVVVVVVVVVVV
VVVVVVVVVVVHVVVVVVVVVVVVVVVVVVVVVVVVVVVVVVVVVV
