PPPPPPPPPPPPPPPPPPPPPPPPPPPPPP
OOOOOOOOOOOOOOOOOOOOOOOOOOOOOO
OOOOOOOOOOOOOXOOOOOOOHOOOOOOOO
OOOOOOOOOOOOPPPOOOOOOHOOOOOOOO
OOOOOOPPPOOOOOOOOOOOOOOOOOOOOO
OOOOOOOOOOOOOOOOOOPPPOOOOOOOOO
OOOOOPPPOOOOOOOOOOOOOOOOOPPPOO
PPPPPPPPPPPPPPPPPPPPPPPPPPPPPP
PPPPPPPPPPPPPPPPPPPPPPPPPPPPPP