OOOOOOOOOOOOOOOOOOOOOOOOOOOOOO
OOOOOOOOOOOOOOOOOOOOOOOOOOOOOO
OOOOOOXOOOOOOOOOOOOOOOOOOOOOOO
OOOPOOOOPOOOOOOOOOOOOOOOOOOOOO
OOOPPPPPPPPPPPPPPPPPPPOOOOOOOO
OOOOOOOOOOOOOOOOOHOOOOOOOOOOOO
OOOOOOOOOOOOOOOOOHOOOOOOOOOOOO
OOOOPPPPPPPPPPPPPPPPPOOOOOOOOO
OOOOOOOOOOOOOOOOOOOOOOOOOOOOOO