OOOOOOOOOOOOOOOOOOOOOOOOOOOOOO
OOOOOOOOOOOOOOOOOOOOOOOOOOOOOO
OOOOOOOOOOOOOOOOOOOOOOOOOOOOOO
OOOOOOOOOOOOOOOOOOOOOOOOOOOOOO
OOOOOOOOOOOOOOOOOOOOOOOOOOOOOO
OOOOOOOOOOOOOOOOOHOOOOOOOOOOOO
OOOOOXOOOOOOOOOOOHOOOOOOOOOOOO
OOOOPPPPPPPPPPPPPPPPPOOOOOOOOO
OOOOOOOOOOOOOOOOOOOOOOOOOOOOOO